############################################################
#.........................................................S#
#####.###########.########...####################.##########
#.###.#............##......##..##################.#...######
#.###.###.###.####.##.########.....###......#####.#.#.....##
#.........#...##...##.############.###.....######...#####.##
###.#####...####.####.####..######.#####.################..#
#...######.......#........................................##
#####################################.######################
#####################################.######################
#..........................................................#
#####.###########.########...####################.##########
#.###.#............##......##..##################.#...######
#.###.###.###.####.##.########.....###......#####.#.#.....##
#.........#...##...##.############.###.....######...#####.##
###.#####...####.####.####..######.#####.################..#
#...######.......#.........................................#
#######################.####################################
#######################.####################################
#..........................................................#
#####.###########.########...####################.##########
#.###.#............##......##..##################.#...######
#.###.###.###.####.##.########.....###......#####.#.#.....##
#.........#...##...##.############.###.....######...#####.##
###.#####...####.####.####..######.#####.################..#
#...######.......#.......................#.................#
########################################.###################
########################################.###################
#..........................................................#
#####.###########.########...####################.##########
#.###.#............##......##..##################.#...######
#.###.###.###.####.##.########.....###......#####.#.#.....##
#.........#...##...##.############.###.....######...#####.##
###.#####...####.####.####..######.#####.################..#
#...######...G...#.........................................#
############################################################
